MAZE 8 16
  1   7   2   7
  2   6   2   7
  3   8   4   8
  2   8   2   9
  5  13   6  13
  3   6   3   7
  2   3   3   3
  1   3   2   3
  1   2   1   3
  5   7   6   7
  4   1   4   2
  6   5   7   5
  1   8   1   9
  2   0   2   1
  5   4   5   5
  1   9   2   9
  4  13   4  14
  0   8   1   8
  0   1   1   1
  4   4   5   4
  5   8   5   9
  1  12   1  13
  0   9   1   9
  3   0   3   1
  3   9   3  10
  5   4   6   4
  0  12   1  12
  6   3   7   3
  2  13   3  13
  2  12   3  12
  1  10   1  11
  3   8   3   9
  5   5   6   5
  4  11   5  11
  6  13   6  14
  5   2   5   3
  1   4   2   4
  3   4   4   4
  4   8   5   8
  5   9   5  10
  6   9   7   9
  1   5   1   6
  3   5   4   5
  4   3   4   4
  5  12   6  12
  5   2   6   2
  1   4   1   5
  6   2   7   2
  3  11   3  12
  6   1   6   2
  3   2   4   2
  5   1   5   2
  1  14   1  15
  2  11   2  12
  5  12   5  13
  3  13   4  13
  0  14   1  14
  4   9   4  10
  0  10   0  11
  2   2   3   2
  2   0   3   0
  0  14   0  15
  0   4   0   5
  2   8   3   8
  6  10   7  10
  5   6   5   7
  4  13   5  13
  7   8   7   9
  1  14   2  14
  6   0   6   1
  4   8   4   9
  2   1   3   1
  4  15   5  15
  3   9   4   9
  0   4   1   4
  6  11   7  11
  6  14   6  15
  6   9   6  10
  3  12   4  12
  6  12   6  13
  6  10   6  11
  7   6   7   7
  0  12   0  13
  0   5   1   5
  2  14   2  15
  5  10   5  11
  4  14   5  14
  5   8   6   8
  7   7   7   8
  3  15   4  15
  3  11   4  11
  2   5   3   5
  1   2   2   2
  6  14   7  14
  2   6   3   6
  3  10   3  11
  6   6   7   6
  6   1   7   1
  0   6   1   6
  2   7   3   7
  5   0   5   1
  4   0   5   0
  4   5   5   5
  0   1   0   2
  3   4   3   5
